0,832,2560,192,15
304,681,383,192,1
1275,709,64,122,1
1748,681,383,192,1
105,551,127,64,1
300,395,127,64,1
71,289,127,64,1
669,323,64,64,1
745,552,64,64,1
897,476,64,64,1
1036,400,64,64,1
1135,289,127,64,1
1387,338,127,64,1
1363,593,127,64,1
1591,441,127,64,1
1648,196,64,64,1
1900,149,383,192,1
1913,559,64,122,1
2199,516,127,64,1
